vscode-icon-symbol-reference-font-family: 'codicon'; --vscode-=
icon-go-to-file-content: '\ea94'; --vscode-icon-go-to-file-font-family: 'co=
dicon'; --vscode-icon-symbol-enum-content: '\ea95'; --vscode-icon-symbol-en=
um-font-family: 'codicon'; --vscode-icon-symbol-value-content: '\ea95'; --v=
scode-icon-symbol-value-font-family: 'codicon'; --vscode-icon-symbol-ruler-=
content: '\ea96'; --vscode-icon-symbol-ruler-font-family: 'codicon'; --vsco=
de-icon-symbol-unit-content: '\ea96'; --vscode-icon-symbol-unit-font-family=
: 'codicon'; --vscode-icon-activate-breakpoints-content: '\ea97'; --vscode-=
icon-activate-breakpoints-font-family: 'codicon'; --vscode-icon-archive-con=
tent: '\ea98'; --vscode-icon-archive-font-family: 'codicon'; --vscode-icon-=
arrow-both-content: '\ea99'; --vscode-icon-arrow-both-font-family: 'codicon=
'; --vscode-icon-arrow-down-content: '\ea9a'; --vscode-icon-arrow-down-font=
-family: 'codicon'; --vscode-icon-arrow-left-content: '\ea9b'; --vscode-ico=
n-arrow-left-font-family: 'codicon'; --vscode-icon-arrow-right-content: '\e=
a9c'; --vscode-icon-arrow-right-font-family: 'codicon'; --vscode-icon-arrow=
-small-down-content: '\ea9d'; --vscode-icon-arrow-small-down-font-family: '=
codicon'; --vscode-icon-arrow-small-left-content: '\ea9e'; --vscode-icon-ar=
row-small-left-font-family: 'codicon'; --vscode-icon-arrow-small-right-cont=
ent: '\ea9f'; --vscode-icon-arrow-small-right-font-family: 'codicon'; --vsc=
ode-icon-arrow-small-up-content: '\eaa0'; --vscode-icon-arrow-small-up-font=
-family: 'codicon'; --vscode-icon-arrow-up-content: '\eaa1'; --vscode-icon-=
arrow-up-font-family: 'codicon'; --vscode-icon-bell-content: '\eaa2'; --vsc=
ode-icon-bell-font-family: 'codicon'; --vscode-icon-bold-content: '\eaa3'; =
--vscode-icon-bold-font-family: 'codicon'; --vscode-icon-book-content: '\ea=
a4'; --vscode-icon-book-font-family: 'codicon'; --vscode-icon-bookmark-cont=
ent: '\eaa5'; --vscode-icon-bookmark-font-family: 'codicon'; --vscode-icon-=
debug-breakpoint-conditional-unverified-content: '\eaa6'; --vscode-icon-deb=
ug-breakpoint-conditional-unverified-font-family: 'codicon'; --vscode-icon-=
debug-breakpoint-conditional-content: '\eaa7'; --vscode-icon-debug-breakpoi=
nt-conditional-font-family: 'codicon'; --vscode-icon-debug-breakpoint-condi=
tional-disabled-content: '\eaa7'; --vscode-icon-debug-breakpoint-conditiona=
l-disabled-font-family: 'codicon'; --vscode-icon-debug-breakpoint-data-unve=
rified-content: '\eaa8'; --vscode-icon-debug-breakpoint-data-unverified-fon=
t-family: 'codicon'; --vscode-icon-debug-breakpoint-data-content: '\eaa9'; =
--vscode-icon-debug-breakpoint-data-font-family: 'codicon'; --vscode-icon-d=
ebug-breakpoint-data-disabled-content: '\eaa9'; --vscode-icon-debug-breakpo=
int-data-disabled-font-family: 'codicon'; --vscode-icon-debug-breakpoint-lo=
g-unverified-content: '\eaaa'; --vscode-icon-debug-breakpoint-log-unverifie=
d-font-family: 'codicon'; --vscode-icon-debug-breakpoint-log-content: '\eaa=
b'; --vscode-icon-debug-breakpoint-log-font-family: 'codicon'; --vscode-ico=
n-debug-breakpoint-log-disabled-content: '\eaab'; --vscode-icon-debug-break=
point-log-disabled-font-family: 'codicon'; --vscode-icon-briefcase-content:=
 '\eaac'; --vscode-icon-briefcase-font-family: 'codicon'; --vscode-icon-bro=
adcast-content: '\eaad'; --vscode-icon-broadcast-font-family: 'codicon'; --=
vscode-icon-browser-content: '\eaae'; --vscode-icon-browser-font-family: 'c=
odicon'; --vscode-icon-bug-content: '\eaaf'; --vscode-icon-bug-font-family:=
 'codicon'; --vscode-icon-calendar-content: '\eab0'; --vscode-icon-calendar=
-font-family: 'codicon'; --vscode-icon-case-sensitive-content: '\eab1'; --v=
scode-icon-case-sensitive-font-family: 'codicon'; --vscode-icon-check-conte=
nt: '\eab2'; --vscode-icon-check-font-family: 'codicon'; --vscode-icon-chec=
klist-content: '\eab3'; --vscode-icon-checklist-font-family: 'codicon'; --v=
scode-icon-chevron-down-content: '\eab4'; --vscode-icon-chevron-down-font-f=
amily: 'c