l-ubuntu-content:=
 '\ebc9'; --vscode-icon-terminal-ubuntu-font-family: 'codicon'; --vscode-ic=
on-terminal-bash-content: '\ebca'; --vscode-icon-terminal-bash-font-family:=
 'codicon'; --vscode-icon-arrow-swap-content: '\ebcb'; --vscode-icon-arrow-=
swap-font-family: 'codicon'; --vscode-icon-copy-content: '\ebcc'; --vscode-=
icon-copy-font-family: 'codicon'; --vscode-icon-person-add-content: '\ebcd'=
; --vscode-icon-person-add-font-family: 'codicon'; --vscode-icon-filter-fil=
led-content: '\ebce'; --vscode-icon-filter-filled-font-family: 'codicon'; -=
-vscode-icon-wand-content: '\ebcf'; --vscode-icon-wand-font-family: 'codico=
n'; --vscode-icon-debug-line-by-line-content: '\ebd0'; --vscode-icon-debug-=
line-by-line-font-family: 'codicon'; --vscode-icon-inspect-content: '\ebd1'=
; --vscode-icon-inspect-font-family: 'codicon'; --vscode-icon-layers-conten=
t: '\ebd2'; --vscode-icon-layers-font-family: 'codicon'; --vscode-icon-laye=
rs-dot-content: '\ebd3'; --vscode-icon-layers-dot-font-family: 'codicon'; -=
-vscode-icon-layers-active-content: '\ebd4'; --vscode-icon-layers-active-fo=
nt-family: 'codicon'; --vscode-icon-compass-content: '\ebd5'; --vscode-icon=
-compass-font-family: 'codicon'; --vscode-icon-compass-dot-content: '\ebd6'=
; --vscode-icon-compass-dot-font-family: 'codicon'; --vscode-icon-compass-a=
ctive-content: '\ebd7'; --vscode-icon-compass-active-font-family: 'codicon'=
; --vscode-icon-azure-content: '\ebd8'; --vscode-icon-azure-font-family: 'c=
odicon'; --vscode-icon-issue-draft-content: '\ebd9'; --vscode-icon-issue-dr=
aft-font-family: 'codicon'; --vscode-icon-git-pull-request-closed-content: =
'\ebda'; --vscode-icon-git-pull-request-closed-font-family: 'codicon'; --vs=
code-icon-git-pull-request-draft-content: '\ebdb'; --vscode-icon-git-pull-r=
equest-draft-font-family: 'codicon'; --vscode-icon-debug-all-content: '\ebd=
c'; --vscode-icon-debug-all-font-family: 'codicon'; --vscode-icon-debug-cov=
erage-content: '\ebdd'; --vscode-icon-debug-coverage-font-family: 'codicon'=
; --vscode-icon-run-errors-content: '\ebde'; --vscode-icon-run-errors-font-=
family: 'codicon'; --vscode-icon-folder-library-content: '\ebdf'; --vscode-=
icon-folder-library-font-family: 'codicon'; --vscode-icon-debug-continue-sm=
all-content: '\ebe0'; --vscode-icon-debug-continue-small-font-family: 'codi=
con'; --vscode-icon-beaker-stop-content: '\ebe1'; --vscode-icon-beaker-stop=
-font-family: 'codicon'; --vscode-icon-graph-line-content: '\ebe2'; --vscod=
e-icon-graph-line-font-family: 'codicon'; --vscode-icon-graph-scatter-conte=
nt: '\ebe3'; --vscode-icon-graph-scatter-font-family: 'codicon'; --vscode-i=
con-pie-chart-content: '\ebe4'; --vscode-icon-pie-chart-font-family: 'codic=
on'; --vscode-icon-bracket-content: '\eb0f'; --vscode-icon-bracket-font-fam=
ily: 'codicon'; --vscode-icon-bracket-dot-content: '\ebe5'; --vscode-icon-b=
racket-dot-font-family: 'codicon'; --vscode-icon-bracket-error-content: '\e=
be6'; --vscode-icon-bracket-error-font-family: 'codicon'; --vscode-icon-loc=
k-small-content: '\ebe7'; --vscode-icon-lock-small-font-family: 'codicon'; =
--vscode-icon-azure-devops-content: '\ebe8'; --vscode-icon-azure-devops-fon=
t-family: 'codicon'; --vscode-icon-verified-filled-content: '\ebe9'; --vsco=
de-icon-verified-filled-font-family: 'codicon'; --vscode-icon-newline-conte=
nt: '\ebea'; --vscode-icon-newline-font-family: 'codicon'; --vscode-icon-la=
yout-content: '\ebeb'; --vscode-icon-layout-font-family: 'codicon'; --vscod=
e-icon-layout-activitybar-left-content: '\ebec'; --vscode-icon-layout-activ=
itybar-left-font-family: 'codicon'; --vscode-icon-layout-activitybar-right-=
content: '\ebed'; --vscode-icon-layout-activitybar-right-font-family: 'codi=
con'; --vscode-icon-layout-panel-left-content: '\ebee'; --vscode-icon-layou=
t-panel-left-font-family: 'codicon'; --vscode-icon-layout-panel-center-cont=
ent: '\ebef'; --vscode-icon-layout-panel-center-font-family: 'codicon'; --v=
scode-icon-layout-panel-justify-content: '\ebf0'; --vs