on-diff-ignored-content: '\eadd'; --vscode-icon-diff-ignored-font-fami=
ly: 'codicon'; --vscode-icon-diff-modified-content: '\eade'; --vscode-icon-=
diff-modified-font-family: 'codicon'; --vscode-icon-diff-removed-content: '=
\eadf'; --vscode-icon-diff-removed-font-family: 'codicon'; --vscode-icon-di=
ff-renamed-content: '\eae0'; --vscode-icon-diff-renamed-font-family: 'codic=
on'; --vscode-icon-diff-content: '\eae1'; --vscode-icon-diff-font-family: '=
codicon'; --vscode-icon-diff-sidebyside-content: '\eae1'; --vscode-icon-dif=
f-sidebyside-font-family: 'codicon'; --vscode-icon-discard-content: '\eae2'=
; --vscode-icon-discard-font-family: 'codicon'; --vscode-icon-editor-layout=
-content: '\eae3'; --vscode-icon-editor-layout-font-family: 'codicon'; --vs=
code-icon-empty-window-content: '\eae4'; --vscode-icon-empty-window-font-fa=
mily: 'codicon'; --vscode-icon-exclude-content: '\eae5'; --vscode-icon-excl=
ude-font-family: 'codicon'; --vscode-icon-extensions-content: '\eae6'; --vs=
code-icon-extensions-font-family: 'codicon'; --vscode-icon-eye-closed-conte=
nt: '\eae7'; --vscode-icon-eye-closed-font-family: 'codicon'; --vscode-icon=
-file-binary-content: '\eae8'; --vscode-icon-file-binary-font-family: 'codi=
con'; --vscode-icon-file-code-content: '\eae9'; --vscode-icon-file-code-fon=
t-family: 'codicon'; --vscode-icon-file-media-content: '\eaea'; --vscode-ic=
on-file-media-font-family: 'codicon'; --vscode-icon-file-pdf-content: '\eae=
b'; --vscode-icon-file-pdf-font-family: 'codicon'; --vscode-icon-file-submo=
dule-content: '\eaec'; --vscode-icon-file-submodule-font-family: 'codicon';=
 --vscode-icon-file-symlink-directory-content: '\eaed'; --vscode-icon-file-=
symlink-directory-font-family: 'codicon'; --vscode-icon-file-symlink-file-c=
ontent: '\eaee'; --vscode-icon-file-symlink-file-font-family: 'codicon'; --=
vscode-icon-file-zip-content: '\eaef'; --vscode-icon-file-zip-font-family: =
'codicon'; --vscode-icon-files-content: '\eaf0'; --vscode-icon-files-font-f=
amily: 'codicon'; --vscode-icon-filter-content: '\eaf1'; --vscode-icon-filt=
er-font-family: 'codicon'; --vscode-icon-flame-content: '\eaf2'; --vscode-i=
con-flame-font-family: 'codicon'; --vscode-icon-fold-down-content: '\eaf3';=
 --vscode-icon-fold-down-font-family: 'codicon'; --vscode-icon-fold-up-cont=
ent: '\eaf4'; --vscode-icon-fold-up-font-family: 'codicon'; --vscode-icon-f=
old-content: '\eaf5'; --vscode-icon-fold-font-family: 'codicon'; --vscode-i=
con-folder-active-content: '\eaf6'; --vscode-icon-folder-active-font-family=
: 'codicon'; --vscode-icon-folder-opened-content: '\eaf7'; --vscode-icon-fo=
lder-opened-font-family: 'codicon'; --vscode-icon-gear-content: '\eaf8'; --=
vscode-icon-gear-font-family: 'codicon'; --vscode-icon-gift-content: '\eaf9=
'; --vscode-icon-gift-font-family: 'codicon'; --vscode-icon-gist-secret-con=
tent: '\eafa'; --vscode-icon-gist-secret-font-family: 'codicon'; --vscode-i=
con-gist-content: '\eafb'; --vscode-icon-gist-font-family: 'codicon'; --vsc=
ode-icon-git-commit-content: '\eafc'; --vscode-icon-git-commit-font-family:=
 'codicon'; --vscode-icon-git-compare-content: '\eafd'; --vscode-icon-git-c=
ompare-font-family: 'codicon'; --vscode-icon-compare-changes-content: '\eaf=
d'; --vscode-icon-compare-changes-font-family: 'codicon'; --vscode-icon-git=
-merge-content: '\eafe'; --vscode-icon-git-merge-font-family: 'codicon'; --=
vscode-icon-github-action-content: '\eaff'; --vscode-icon-github-action-fon=
t-family: 'codicon'; --vscode-icon-github-alt-content: '\eb00'; --vscode-ic=
on-github-alt-font-family: 'codicon'; --vscode-icon-globe-content: '\eb01';=
 --vscode-icon-globe-font-family: 'codicon'; --vscode-icon-grabber-content:=
 '\eb02'; --vscode-icon-grabber-font-family: 'codicon'; --vscode-icon-graph=
-content: '\eb03'; --vscode-icon-graph-font-family: 'codicon'; --vscode-ico=
n-gripper-content: '\eb04'; --vscode-icon-gripper-font-family: 'codicon'; -=
-vscode-icon-heart-content: '\eb05'; --vscode-icon-heart-font-family: 'codi=
c