odicon'; --vscode-icon-chevron-left-content: '\eab5'; --vscode-ico=
n-chevron-left-font-family: 'codicon'; --vscode-icon-chevron-right-content:=
 '\eab6'; --vscode-icon-chevron-right-font-family: 'codicon'; --vscode-icon=
-chevron-up-content: '\eab7'; --vscode-icon-chevron-up-font-family: 'codico=
n'; --vscode-icon-chrome-close-content: '\eab8'; --vscode-icon-chrome-close=
-font-family: 'codicon'; --vscode-icon-chrome-maximize-content: '\eab9'; --=
vscode-icon-chrome-maximize-font-family: 'codicon'; --vscode-icon-chrome-mi=
nimize-content: '\eaba'; --vscode-icon-chrome-minimize-font-family: 'codico=
n'; --vscode-icon-chrome-restore-content: '\eabb'; --vscode-icon-chrome-res=
tore-font-family: 'codicon'; --vscode-icon-circle-outline-content: '\eabc';=
 --vscode-icon-circle-outline-font-family: 'codicon'; --vscode-icon-circle-=
content: '\eabc'; --vscode-icon-circle-font-family: 'codicon'; --vscode-ico=
n-debug-breakpoint-unverified-content: '\eabc'; --vscode-icon-debug-breakpo=
int-unverified-font-family: 'codicon'; --vscode-icon-terminal-decoration-in=
complete-content: '\eabc'; --vscode-icon-terminal-decoration-incomplete-fon=
t-family: 'codicon'; --vscode-icon-circle-slash-content: '\eabd'; --vscode-=
icon-circle-slash-font-family: 'codicon'; --vscode-icon-circuit-board-conte=
nt: '\eabe'; --vscode-icon-circuit-board-font-family: 'codicon'; --vscode-i=
con-clear-all-content: '\eabf'; --vscode-icon-clear-all-font-family: 'codic=
on'; --vscode-icon-clippy-content: '\eac0'; --vscode-icon-clippy-font-famil=
y: 'codicon'; --vscode-icon-close-all-content: '\eac1'; --vscode-icon-close=
-all-font-family: 'codicon'; --vscode-icon-cloud-download-content: '\eac2';=
 --vscode-icon-cloud-download-font-family: 'codicon'; --vscode-icon-cloud-u=
pload-content: '\eac3'; --vscode-icon-cloud-upload-font-family: 'codicon'; =
--vscode-icon-code-content: '\eac4'; --vscode-icon-code-font-family: 'codic=
on'; --vscode-icon-collapse-all-content: '\eac5'; --vscode-icon-collapse-al=
l-font-family: 'codicon'; --vscode-icon-color-mode-content: '\eac6'; --vsco=
de-icon-color-mode-font-family: 'codicon'; --vscode-icon-comment-discussion=
-content: '\eac7'; --vscode-icon-comment-discussion-font-family: 'codicon';=
 --vscode-icon-credit-card-content: '\eac9'; --vscode-icon-credit-card-font=
-family: 'codicon'; --vscode-icon-dash-content: '\eacc'; --vscode-icon-dash=
-font-family: 'codicon'; --vscode-icon-dashboard-content: '\eacd'; --vscode=
-icon-dashboard-font-family: 'codicon'; --vscode-icon-database-content: '\e=
ace'; --vscode-icon-database-font-family: 'codicon'; --vscode-icon-debug-co=
ntinue-content: '\eacf'; --vscode-icon-debug-continue-font-family: 'codicon=
'; --vscode-icon-debug-disconnect-content: '\ead0'; --vscode-icon-debug-dis=
connect-font-family: 'codicon'; --vscode-icon-debug-pause-content: '\ead1';=
 --vscode-icon-debug-pause-font-family: 'codicon'; --vscode-icon-debug-rest=
art-content: '\ead2'; --vscode-icon-debug-restart-font-family: 'codicon'; -=
-vscode-icon-debug-start-content: '\ead3'; --vscode-icon-debug-start-font-f=
amily: 'codicon'; --vscode-icon-debug-step-into-content: '\ead4'; --vscode-=
icon-debug-step-into-font-family: 'codicon'; --vscode-icon-debug-step-out-c=
ontent: '\ead5'; --vscode-icon-debug-step-out-font-family: 'codicon'; --vsc=
ode-icon-debug-step-over-content: '\ead6'; --vscode-icon-debug-step-over-fo=
nt-family: 'codicon'; --vscode-icon-debug-stop-content: '\ead7'; --vscode-i=
con-debug-stop-font-family: 'codicon'; --vscode-icon-debug-content: '\ead8'=
; --vscode-icon-debug-font-family: 'codicon'; --vscode-icon-device-camera-v=
ideo-content: '\ead9'; --vscode-icon-device-camera-video-font-family: 'codi=
con'; --vscode-icon-device-camera-content: '\eada'; --vscode-icon-device-ca=
mera-font-family: 'codicon'; --vscode-icon-device-mobile-content: '\eadb'; =
--vscode-icon-device-mobile-font-family: 'codicon'; --vscode-icon-diff-adde=
d-content: '\eadc'; --vscode-icon-diff-added-font-family: 'codicon'; --vsco=
de-ic