ode-icon-file-add-content: '\ea7f'; --vscode-icon-file-add=
-font-family: 'codicon'; --vscode-icon-new-folder-content: '\ea80'; --vscod=
e-icon-new-folder-font-family: 'codicon'; --vscode-icon-file-directory-crea=
te-content: '\ea80'; --vscode-icon-file-directory-create-font-family: 'codi=
con'; --vscode-icon-trash-content: '\ea81'; --vscode-icon-trash-font-family=
: 'codicon'; --vscode-icon-trashcan-content: '\ea81'; --vscode-icon-trashca=
n-font-family: 'codicon'; --vscode-icon-history-content: '\ea82'; --vscode-=
icon-history-font-family: 'codicon'; --vscode-icon-clock-content: '\ea82'; =
--vscode-icon-clock-font-family: 'codicon'; --vscode-icon-folder-content: '=
\ea83'; --vscode-icon-folder-font-family: 'codicon'; --vscode-icon-file-dir=
ectory-content: '\ea83'; --vscode-icon-file-directory-font-family: 'codicon=
'; --vscode-icon-symbol-folder-content: '\ea83'; --vscode-icon-symbol-folde=
r-font-family: 'codicon'; --vscode-icon-logo-github-content: '\ea84'; --vsc=
ode-icon-logo-github-font-family: 'codicon'; --vscode-icon-mark-github-cont=
ent: '\ea84'; --vscode-icon-mark-github-font-family: 'codicon'; --vscode-ic=
on-github-content: '\ea84'; --vscode-icon-github-font-family: 'codicon'; --=
vscode-icon-terminal-content: '\ea85'; --vscode-icon-terminal-font-family: =
'codicon'; --vscode-icon-console-content: '\ea85'; --vscode-icon-console-fo=
nt-family: 'codicon'; --vscode-icon-repl-content: '\ea85'; --vscode-icon-re=
pl-font-family: 'codicon'; --vscode-icon-zap-content: '\ea86'; --vscode-ico=
n-zap-font-family: 'codicon'; --vscode-icon-symbol-event-content: '\ea86'; =
--vscode-icon-symbol-event-font-family: 'codicon'; --vscode-icon-error-cont=
ent: '\ea87'; --vscode-icon-error-font-family: 'codicon'; --vscode-icon-sto=
p-content: '\ea87'; --vscode-icon-stop-font-family: 'codicon'; --vscode-ico=
n-variable-content: '\ea88'; --vscode-icon-variable-font-family: 'codicon';=
 --vscode-icon-symbol-variable-content: '\ea88'; --vscode-icon-symbol-varia=
ble-font-family: 'codicon'; --vscode-icon-array-content: '\ea8a'; --vscode-=
icon-array-font-family: 'codicon'; --vscode-icon-symbol-array-content: '\ea=
8a'; --vscode-icon-symbol-array-font-family: 'codicon'; --vscode-icon-symbo=
l-module-content: '\ea8b'; --vscode-icon-symbol-module-font-family: 'codico=
n'; --vscode-icon-symbol-package-content: '\ea8b'; --vscode-icon-symbol-pac=
kage-font-family: 'codicon'; --vscode-icon-symbol-namespace-content: '\ea8b=
'; --vscode-icon-symbol-namespace-font-family: 'codicon'; --vscode-icon-sym=
bol-object-content: '\ea8b'; --vscode-icon-symbol-object-font-family: 'codi=
con'; --vscode-icon-symbol-method-content: '\ea8c'; --vscode-icon-symbol-me=
thod-font-family: 'codicon'; --vscode-icon-symbol-function-content: '\ea8c'=
; --vscode-icon-symbol-function-font-family: 'codicon'; --vscode-icon-symbo=
l-constructor-content: '\ea8c'; --vscode-icon-symbol-constructor-font-famil=
y: 'codicon'; --vscode-icon-symbol-boolean-content: '\ea8f'; --vscode-icon-=
symbol-boolean-font-family: 'codicon'; --vscode-icon-symbol-null-content: '=
\ea8f'; --vscode-icon-symbol-null-font-family: 'codicon'; --vscode-icon-sym=
bol-numeric-content: '\ea90'; --vscode-icon-symbol-numeric-font-family: 'co=
dicon'; --vscode-icon-symbol-number-content: '\ea90'; --vscode-icon-symbol-=
number-font-family: 'codicon'; --vscode-icon-symbol-structure-content: '\ea=
91'; --vscode-icon-symbol-structure-font-family: 'codicon'; --vscode-icon-s=
ymbol-struct-content: '\ea91'; --vscode-icon-symbol-struct-font-family: 'co=
dicon'; --vscode-icon-symbol-parameter-content: '\ea92'; --vscode-icon-symb=
ol-parameter-font-family: 'codicon'; --vscode-icon-symbol-type-parameter-co=
ntent: '\ea92'; --vscode-icon-symbol-type-parameter-font-family: 'codicon';=
 --vscode-icon-symbol-key-content: '\ea93'; --vscode-icon-symbol-key-font-f=
amily: 'codicon'; --vscode-icon-symbol-text-content: '\ea93'; --vscode-icon=
-symbol-text-font-family: 'codicon'; --vscode-icon-symbol-reference-content=
: '\ea94'; --