lose-font-family: 'codicon'; =
--vscode-icon-tree-item-expanded-content: '\eab4'; --vscode-icon-tree-item-=
expanded-font-family: 'codicon'; --vscode-icon-tree-filter-on-type-on-conte=
nt: '\eb83'; --vscode-icon-tree-filter-on-type-on-font-family: 'codicon'; -=
-vscode-icon-tree-filter-on-type-off-content: '\eb85'; --vscode-icon-tree-f=
ilter-on-type-off-font-family: 'codicon'; --vscode-icon-tree-filter-clear-c=
ontent: '\ea76'; --vscode-icon-tree-filter-clear-font-family: 'codicon'; --=
vscode-icon-tree-item-loading-content: '\eb19'; --vscode-icon-tree-item-loa=
ding-font-family: 'codicon'; --vscode-icon-menu-selection-content: '\eab2';=
 --vscode-icon-menu-selection-font-family: 'codicon'; --vscode-icon-menu-su=
bmenu-content: '\eab6'; --vscode-icon-menu-submenu-font-family: 'codicon'; =
--vscode-icon-menubar-more-content: '\ea7c'; --vscode-icon-menubar-more-fon=
t-family: 'codicon'; --vscode-icon-scrollbar-button-left-content: '\eb6f'; =
--vscode-icon-scrollbar-button-left-font-family: 'codicon'; --vscode-icon-s=
crollbar-button-right-content: '\eb70'; --vscode-icon-scrollbar-button-righ=
t-font-family: 'codicon'; --vscode-icon-scrollbar-button-up-content: '\eb71=
'; --vscode-icon-scrollbar-button-up-font-family: 'codicon'; --vscode-icon-=
scrollbar-button-down-content: '\eb6e'; --vscode-icon-scrollbar-button-down=
-font-family: 'codicon'; --vscode-icon-toolbar-more-content: '\ea7c'; --vsc=
ode-icon-toolbar-more-font-family: 'codicon'; --vscode-icon-quick-input-bac=
k-content: '\ea9b'; --vscode-icon-quick-input-back-font-family: 'codicon'; =
--vscode-icon-drop-down-button-content: '\eab4'; --vscode-icon-drop-down-bu=
tton-font-family: 'codicon'; --vscode-icon-symbol-customcolor-content: '\eb=
5c'; --vscode-icon-symbol-customcolor-font-family: 'codicon'; --vscode-icon=
-workspace-unspecified-content: '\ebc3'; --vscode-icon-workspace-unspecifie=
d-font-family: 'codicon'; --vscode-icon-git-fetch-content: '\ec1d'; --vscod=
e-icon-git-fetch-font-family: 'codicon'; --vscode-icon-lightbulb-sparkle-au=
tofix-content: '\ec1f'; --vscode-icon-lightbulb-sparkle-autofix-font-family=
: 'codicon'; --vscode-icon-debug-breakpoint-pending-content: '\ebd9'; --vsc=
ode-icon-debug-breakpoint-pending-font-family: 'codicon'; --vscode-icon-wid=
get-close-content: '\ea76'; --vscode-icon-widget-close-font-family: 'codico=
n'; --vscode-icon-goto-previous-location-content: '\eaa1'; --vscode-icon-go=
to-previous-location-font-family: 'codicon'; --vscode-icon-goto-next-locati=
on-content: '\ea9a'; --vscode-icon-goto-next-location-font-family: 'codicon=
'; --vscode-icon-diff-review-insert-content: '\ea60'; --vscode-icon-diff-re=
view-insert-font-family: 'codicon'; --vscode-icon-diff-review-remove-conten=
t: '\eb3b'; --vscode-icon-diff-review-remove-font-family: 'codicon'; --vsco=
de-icon-diff-review-close-content: '\ea76'; --vscode-icon-diff-review-close=
-font-family: 'codicon'; --vscode-icon-hover-increase-verbosity-content: '\=
ea60'; --vscode-icon-hover-increase-verbosity-font-family: 'codicon'; --vsc=
ode-icon-hover-decrease-verbosity-content: '\eb3b'; --vscode-icon-hover-dec=
rease-verbosity-font-family: 'codicon'; --vscode-icon-parameter-hints-next-=
content: '\eab4'; --vscode-icon-parameter-hints-next-font-family: 'codicon'=
; --vscode-icon-parameter-hints-previous-content: '\eab7'; --vscode-icon-pa=
rameter-hints-previous-font-family: 'codicon'; --vscode-icon-suggest-more-i=
nfo-content: '\eab6'; --vscode-icon-suggest-more-info-font-family: 'codicon=
'; --vscode-icon-inline-suggestion-hints-next-content: '\eab6'; --vscode-ic=
on-inline-suggestion-hints-next-font-family: 'codicon'; --vscode-icon-inlin=
e-suggestion-hints-previous-content: '\eab5'; --vscode-icon-inline-suggesti=
on-hints-previous-font-family: 'codicon'; --vscode-icon-diff-insert-content=
: '\ea60'; --vscode-icon-diff-insert-font-family: 'codicon'; --vscode-icon-=
diff-remove-content: '\eb3b'; --vscode-icon-diff-remove-font-family: 'codic=
on'; --vscode-icon-find-collapsed-content: