code-icon-layout-pane=
l-justify-font-family: 'codicon'; --vscode-icon-layout-panel-right-content:=
 '\ebf1'; --vscode-icon-layout-panel-right-font-family: 'codicon'; --vscode=
-icon-layout-panel-content: '\ebf2'; --vscode-icon-layout-panel-font-family=
: 'codicon'; --vscode-icon-layout-sidebar-left-content: '\ebf3'; --vscode-i=
con-layout-sidebar-left-font-family: 'codicon'; --vscode-icon-layout-sideba=
r-right-content: '\ebf4'; --vscode-icon-layout-sidebar-right-font-family: '=
codicon'; --vscode-icon-layout-statusbar-content: '\ebf5'; --vscode-icon-la=
yout-statusbar-font-family: 'codicon'; --vscode-icon-layout-menubar-content=
: '\ebf6'; --vscode-icon-layout-menubar-font-family: 'codicon'; --vscode-ic=
on-layout-centered-content: '\ebf7'; --vscode-icon-layout-centered-font-fam=
ily: 'codicon'; --vscode-icon-target-content: '\ebf8'; --vscode-icon-target=
-font-family: 'codicon'; --vscode-icon-indent-content: '\ebf9'; --vscode-ic=
on-indent-font-family: 'codicon'; --vscode-icon-record-small-content: '\ebf=
a'; --vscode-icon-record-small-font-family: 'codicon'; --vscode-icon-error-=
small-content: '\ebfb'; --vscode-icon-error-small-font-family: 'codicon'; -=
-vscode-icon-terminal-decoration-error-content: '\ebfb'; --vscode-icon-term=
inal-decoration-error-font-family: 'codicon'; --vscode-icon-arrow-circle-do=
wn-content: '\ebfc'; --vscode-icon-arrow-circle-down-font-family: 'codicon'=
; --vscode-icon-arrow-circle-left-content: '\ebfd'; --vscode-icon-arrow-cir=
cle-left-font-family: 'codicon'; --vscode-icon-arrow-circle-right-content: =
'\ebfe'; --vscode-icon-arrow-circle-right-font-family: 'codicon'; --vscode-=
icon-arrow-circle-up-content: '\ebff'; --vscode-icon-arrow-circle-up-font-f=
amily: 'codicon'; --vscode-icon-layout-sidebar-right-off-content: '\ec00'; =
--vscode-icon-layout-sidebar-right-off-font-family: 'codicon'; --vscode-ico=
n-layout-panel-off-content: '\ec01'; --vscode-icon-layout-panel-off-font-fa=
mily: 'codicon'; --vscode-icon-layout-sidebar-left-off-content: '\ec02'; --=
vscode-icon-layout-sidebar-left-off-font-family: 'codicon'; --vscode-icon-b=
lank-content: '\ec03'; --vscode-icon-blank-font-family: 'codicon'; --vscode=
-icon-heart-filled-content: '\ec04'; --vscode-icon-heart-filled-font-family=
: 'codicon'; --vscode-icon-map-content: '\ec05'; --vscode-icon-map-font-fam=
ily: 'codicon'; --vscode-icon-map-horizontal-content: '\ec05'; --vscode-ico=
n-map-horizontal-font-family: 'codicon'; --vscode-icon-fold-horizontal-cont=
ent: '\ec05'; --vscode-icon-fold-horizontal-font-family: 'codicon'; --vscod=
e-icon-map-filled-content: '\ec06'; --vscode-icon-map-filled-font-family: '=
codicon'; --vscode-icon-map-horizontal-filled-content: '\ec06'; --vscode-ic=
on-map-horizontal-filled-font-family: 'codicon'; --vscode-icon-fold-horizon=
tal-filled-content: '\ec06'; --vscode-icon-fold-horizontal-filled-font-fami=
ly: 'codicon'; --vscode-icon-circle-small-content: '\ec07'; --vscode-icon-c=
ircle-small-font-family: 'codicon'; --vscode-icon-bell-slash-content: '\ec0=
8'; --vscode-icon-bell-slash-font-family: 'codicon'; --vscode-icon-bell-sla=
sh-dot-content: '\ec09'; --vscode-icon-bell-slash-dot-font-family: 'codicon=
'; --vscode-icon-comment-unresolved-content: '\ec0a'; --vscode-icon-comment=
-unresolved-font-family: 'codicon'; --vscode-icon-git-pull-request-go-to-ch=
anges-content: '\ec0b'; --vscode-icon-git-pull-request-go-to-changes-font-f=
amily: 'codicon'; --vscode-icon-git-pull-request-new-changes-content: '\ec0=
c'; --vscode-icon-git-pull-request-new-changes-font-family: 'codicon'; --vs=
code-icon-search-fuzzy-content: '\ec0d'; --vscode-icon-search-fuzzy-font-fa=
mily: 'codicon'; --vscode-icon-comment-draft-content: '\ec0e'; --vscode-ico=
n-comment-draft-font-family: 'codicon'; --vscode-icon-send-content: '\ec0f'=
; --vscode-icon-send-font-family: 'codicon'; --vscode-icon-sparkle-content:=
 '\ec10'; --vscode-icon-sparkle-font-family: 'codicon'; --vscode-icon-inser=
t-content: '\ec11'; --vscode-icon-insert-font-fami