itial;=
 min-height: initial; min-inline-size: initial; min-width: initial; mix-ble=
nd-mode: initial; object-fit: initial; object-position: initial; object-vie=
w-box: initial; offset: initial; opacity: initial; order: initial; orphans:=
 initial; outline: initial; outline-offset: initial; overflow-anchor: initi=
al; overflow-block: initial; overflow-clip-margin: initial; overflow-inline=
: initial; overflow-wrap: initial; overflow: initial; overlay: initial; ove=
rscroll-behavior-block: initial; overscroll-behavior-inline: initial; overs=
croll-behavior: initial; padding-block: initial; padding: initial; padding-=
inline: initial; page: initial; page-orientation: initial; paint-order: ini=
tial; perspective: initial; perspective-origin: initial; pointer-events: in=
itial; position-try: initial; position-visibility: initial; print-color-adj=
ust: initial; quotes: initial; r: initial; reading-flow: initial; reading-o=
rder: initial; resize: initial; rotate: initial; ruby-align: initial; ruby-=
position: initial; rx: initial; ry: initial; scale: initial; scroll-behavio=
r: initial; scroll-initial-target: initial; scroll-margin-block: initial; s=
croll-margin: initial; scroll-margin-inline: initial; scroll-marker-group: =
initial; scroll-padding-block: initial; scroll-padding: initial; scroll-pad=
ding-inline: initial; scroll-snap-align: initial; scroll-snap-stop: initial=
; scroll-snap-type: initial; scroll-target-group: initial; scroll-timeline:=
 initial; scrollbar-color: initial; scrollbar-gutter: initial; scrollbar-wi=
dth: initial; shape-image-threshold: initial; shape-margin: initial; shape-=
outside: initial; shape-rendering: initial; size: initial; speak: initial; =
stop-color: initial; stop-opacity: initial; stroke: initial; stroke-dasharr=
ay: initial; stroke-dashoffset: initial; stroke-linecap: initial; stroke-li=
nejoin: initial; stroke-miterlimit: initial; stroke-opacity: initial; strok=
e-width: initial; tab-size: initial; table-layout: initial; text-align: ini=
tial; text-align-last: initial; text-anchor: initial; text-autospace: initi=
al; text-box: initial; text-combine-upright: initial; text-decoration: init=
ial; text-decoration-skip-ink: initial; text-emphasis: initial; text-emphas=
is-position: initial; text-indent: initial; text-overflow: initial; text-sh=
adow: initial; text-transform: initial; text-underline-offset: initial; tex=
t-underline-position: initial; text-wrap: initial; timeline-scope: initial;=
 touch-action: initial; transform: initial; transform-box: initial; transfo=
rm-origin: initial; transform-style: initial; transition: initial; translat=
e: initial; user-select: initial; vector-effect: initial; vertical-align: i=
nitial; view-timeline: initial; view-transition-class: initial; view-transi=
tion-group: initial; view-transition-name: initial; visibility: initial; bo=
rder-spacing: initial; -webkit-box-align: initial; -webkit-box-decoration-b=
reak: initial; -webkit-box-direction: initial; -webkit-box-flex: initial; -=
webkit-box-ordinal-group: initial; -webkit-box-orient: initial; -webkit-box=
-pack: initial; -webkit-box-reflect: initial; -webkit-line-break: initial; =
-webkit-line-clamp: initial; -webkit-mask-box-image: initial; -webkit-rtl-o=
rdering: initial; -webkit-ruby-position: initial; -webkit-tap-highlight-col=
or: initial; -webkit-text-combine: initial; -webkit-text-decorations-in-eff=
ect: initial; -webkit-text-fill-color: initial; -webkit-text-security: init=
ial; -webkit-text-stroke: initial; -webkit-user-drag: initial; white-space-=
collapse: initial; widows: initial; width: initial; will-change: initial; w=
ord-break: initial; word-spacing: initial; x: initial; y: initial; z-index:=
 initial; }

.monaco-count-badge { border-radius: 11px; box-sizing: border-box; display:=
 inline-block; font-size: 11px; font-weight: 400; line-height: 11px; min-he=
ight: 18px; min-width: 18px; padding: 3px 6px; text-align: center; }

.monaco-count-badge.long { border-radius: 2px; line-height: