odico=
n'; --vscode-icon-symbol-constant-content: '\eb5d'; --vscode-icon-symbol-co=
nstant-font-family: 'codicon'; --vscode-icon-symbol-enum-member-content: '\=
eb5e'; --vscode-icon-symbol-enum-member-font-family: 'codicon'; --vscode-ic=
on-symbol-field-content: '\eb5f'; --vscode-icon-symbol-field-font-family: '=
codicon'; --vscode-icon-symbol-file-content: '\eb60'; --vscode-icon-symbol-=
file-font-family: 'codicon'; --vscode-icon-symbol-interface-content: '\eb61=
'; --vscode-icon-symbol-interface-font-family: 'codicon'; --vscode-icon-sym=
bol-keyword-content: '\eb62'; --vscode-icon-symbol-keyword-font-family: 'co=
dicon'; --vscode-icon-symbol-misc-content: '\eb63'; --vscode-icon-symbol-mi=
sc-font-family: 'codicon'; --vscode-icon-symbol-operator-content: '\eb64'; =
--vscode-icon-symbol-operator-font-family: 'codicon'; --vscode-icon-symbol-=
property-content: '\eb65'; --vscode-icon-symbol-property-font-family: 'codi=
con'; --vscode-icon-wrench-content: '\eb65'; --vscode-icon-wrench-font-fami=
ly: 'codicon'; --vscode-icon-wrench-subaction-content: '\eb65'; --vscode-ic=
on-wrench-subaction-font-family: 'codicon'; --vscode-icon-symbol-snippet-co=
ntent: '\eb66'; --vscode-icon-symbol-snippet-font-family: 'codicon'; --vsco=
de-icon-tasklist-content: '\eb67'; --vscode-icon-tasklist-font-family: 'cod=
icon'; --vscode-icon-telescope-content: '\eb68'; --vscode-icon-telescope-fo=
nt-family: 'codicon'; --vscode-icon-text-size-content: '\eb69'; --vscode-ic=
on-text-size-font-family: 'codicon'; --vscode-icon-three-bars-content: '\eb=
6a'; --vscode-icon-three-bars-font-family: 'codicon'; --vscode-icon-thumbsd=
own-content: '\eb6b'; --vscode-icon-thumbsdown-font-family: 'codicon'; --vs=
code-icon-thumbsup-content: '\eb6c'; --vscode-icon-thumbsup-font-family: 'c=
odicon'; --vscode-icon-tools-content: '\eb6d'; --vscode-icon-tools-font-fam=
ily: 'codicon'; --vscode-icon-triangle-down-content: '\eb6e'; --vscode-icon=
-triangle-down-font-family: 'codicon'; --vscode-icon-triangle-left-content:=
 '\eb6f'; --vscode-icon-triangle-left-font-family: 'codicon'; --vscode-icon=
-triangle-right-content: '\eb70'; --vscode-icon-triangle-right-font-family:=
 'codicon'; --vscode-icon-triangle-up-content: '\eb71'; --vscode-icon-trian=
gle-up-font-family: 'codicon'; --vscode-icon-twitter-content: '\eb72'; --vs=
code-icon-twitter-font-family: 'codicon'; --vscode-icon-unfold-content: '\e=
b73'; --vscode-icon-unfold-font-family: 'codicon'; --vscode-icon-unlock-con=
tent: '\eb74'; --vscode-icon-unlock-font-family: 'codicon'; --vscode-icon-u=
nmute-content: '\eb75'; --vscode-icon-unmute-font-family: 'codicon'; --vsco=
de-icon-unverified-content: '\eb76'; --vscode-icon-unverified-font-family: =
'codicon'; --vscode-icon-verified-content: '\eb77'; --vscode-icon-verified-=
font-family: 'codicon'; --vscode-icon-versions-content: '\eb78'; --vscode-i=
con-versions-font-family: 'codicon'; --vscode-icon-vm-active-content: '\eb7=
9'; --vscode-icon-vm-active-font-family: 'codicon'; --vscode-icon-vm-outlin=
e-content: '\eb7a'; --vscode-icon-vm-outline-font-family: 'codicon'; --vsco=
de-icon-vm-running-content: '\eb7b'; --vscode-icon-vm-running-font-family: =
'codicon'; --vscode-icon-watch-content: '\eb7c'; --vscode-icon-watch-font-f=
amily: 'codicon'; --vscode-icon-whitespace-content: '\eb7d'; --vscode-icon-=
whitespace-font-family: 'codicon'; --vscode-icon-whole-word-content: '\eb7e=
'; --vscode-icon-whole-word-font-family: 'codicon'; --vscode-icon-window-co=
ntent: '\eb7f'; --vscode-icon-window-font-family: 'codicon'; --vscode-icon-=
word-wrap-content: '\eb80'; --vscode-icon-word-wrap-font-family: 'codicon';=
 --vscode-icon-zoom-in-content: '\eb81'; --vscode-icon-zoom-in-font-family:=
 'codicon'; --vscode-icon-zoom-out-content: '\eb82'; --vscode-icon-zoom-out=
-font-family: 'codicon'; --vscode-icon-list-filter-content: '\eb83'; --vsco=
de-icon-list-filter-font-family: 'codicon'; --vscode-icon-list-flat-content=
: '\eb84'; --vscode-icon-list-flat-font-family: 'codicon'; --vscod