n-server-envi=
ronment-font-family: 'codicon'; --vscode-icon-pass-content: '\eba4'; --vsco=
de-icon-pass-font-family: 'codicon'; --vscode-icon-issue-closed-content: '\=
eba4'; --vscode-icon-issue-closed-font-family: 'codicon'; --vscode-icon-sto=
p-circle-content: '\eba5'; --vscode-icon-stop-circle-font-family: 'codicon'=
; --vscode-icon-play-circle-content: '\eba6'; --vscode-icon-play-circle-fon=
t-family: 'codicon'; --vscode-icon-record-content: '\eba7'; --vscode-icon-r=
ecord-font-family: 'codicon'; --vscode-icon-debug-alt-small-content: '\eba8=
'; --vscode-icon-debug-alt-small-font-family: 'codicon'; --vscode-icon-vm-c=
onnect-content: '\eba9'; --vscode-icon-vm-connect-font-family: 'codicon'; -=
-vscode-icon-cloud-content: '\ebaa'; --vscode-icon-cloud-font-family: 'codi=
con'; --vscode-icon-merge-content: '\ebab'; --vscode-icon-merge-font-family=
: 'codicon'; --vscode-icon-export-content: '\ebac'; --vscode-icon-export-fo=
nt-family: 'codicon'; --vscode-icon-graph-left-content: '\ebad'; --vscode-i=
con-graph-left-font-family: 'codicon'; --vscode-icon-magnet-content: '\ebae=
'; --vscode-icon-magnet-font-family: 'codicon'; --vscode-icon-notebook-cont=
ent: '\ebaf'; --vscode-icon-notebook-font-family: 'codicon'; --vscode-icon-=
redo-content: '\ebb0'; --vscode-icon-redo-font-family: 'codicon'; --vscode-=
icon-check-all-content: '\ebb1'; --vscode-icon-check-all-font-family: 'codi=
con'; --vscode-icon-pinned-dirty-content: '\ebb2'; --vscode-icon-pinned-dir=
ty-font-family: 'codicon'; --vscode-icon-pass-filled-content: '\ebb3'; --vs=
code-icon-pass-filled-font-family: 'codicon'; --vscode-icon-circle-large-fi=
lled-content: '\ebb4'; --vscode-icon-circle-large-filled-font-family: 'codi=
con'; --vscode-icon-circle-large-content: '\ebb5'; --vscode-icon-circle-lar=
ge-font-family: 'codicon'; --vscode-icon-circle-large-outline-content: '\eb=
b5'; --vscode-icon-circle-large-outline-font-family: 'codicon'; --vscode-ic=
on-combine-content: '\ebb6'; --vscode-icon-combine-font-family: 'codicon'; =
--vscode-icon-gather-content: '\ebb6'; --vscode-icon-gather-font-family: 'c=
odicon'; --vscode-icon-table-content: '\ebb7'; --vscode-icon-table-font-fam=
ily: 'codicon'; --vscode-icon-variable-group-content: '\ebb8'; --vscode-ico=
n-variable-group-font-family: 'codicon'; --vscode-icon-type-hierarchy-conte=
nt: '\ebb9'; --vscode-icon-type-hierarchy-font-family: 'codicon'; --vscode-=
icon-type-hierarchy-sub-content: '\ebba'; --vscode-icon-type-hierarchy-sub-=
font-family: 'codicon'; --vscode-icon-type-hierarchy-super-content: '\ebbb'=
; --vscode-icon-type-hierarchy-super-font-family: 'codicon'; --vscode-icon-=
git-pull-request-create-content: '\ebbc'; --vscode-icon-git-pull-request-cr=
eate-font-family: 'codicon'; --vscode-icon-run-above-content: '\ebbd'; --vs=
code-icon-run-above-font-family: 'codicon'; --vscode-icon-run-below-content=
: '\ebbe'; --vscode-icon-run-below-font-family: 'codicon'; --vscode-icon-no=
tebook-template-content: '\ebbf'; --vscode-icon-notebook-template-font-fami=
ly: 'codicon'; --vscode-icon-debug-rerun-content: '\ebc0'; --vscode-icon-de=
bug-rerun-font-family: 'codicon'; --vscode-icon-workspace-trusted-content: =
'\ebc1'; --vscode-icon-workspace-trusted-font-family: 'codicon'; --vscode-i=
con-workspace-untrusted-content: '\ebc2'; --vscode-icon-workspace-untrusted=
-font-family: 'codicon'; --vscode-icon-workspace-unknown-content: '\ebc3'; =
--vscode-icon-workspace-unknown-font-family: 'codicon'; --vscode-icon-termi=
nal-cmd-content: '\ebc4'; --vscode-icon-terminal-cmd-font-family: 'codicon'=
; --vscode-icon-terminal-debian-content: '\ebc5'; --vscode-icon-terminal-de=
bian-font-family: 'codicon'; --vscode-icon-terminal-linux-content: '\ebc6';=
 --vscode-icon-terminal-linux-font-family: 'codicon'; --vscode-icon-termina=
l-powershell-content: '\ebc7'; --vscode-icon-terminal-powershell-font-famil=
y: 'codicon'; --vscode-icon-terminal-tmux-content: '\ebc8'; --vscode-icon-t=
erminal-tmux-font-family: 'codicon'; --vscode-icon-termina