'=
codicon'; --vscode-icon-pulse-content: '\eb31'; --vscode-icon-pulse-font-fa=
mily: 'codicon'; --vscode-icon-question-content: '\eb32'; --vscode-icon-que=
stion-font-family: 'codicon'; --vscode-icon-quote-content: '\eb33'; --vscod=
e-icon-quote-font-family: 'codicon'; --vscode-icon-radio-tower-content: '\e=
b34'; --vscode-icon-radio-tower-font-family: 'codicon'; --vscode-icon-react=
ions-content: '\eb35'; --vscode-icon-reactions-font-family: 'codicon'; --vs=
code-icon-references-content: '\eb36'; --vscode-icon-references-font-family=
: 'codicon'; --vscode-icon-refresh-content: '\eb37'; --vscode-icon-refresh-=
font-family: 'codicon'; --vscode-icon-regex-content: '\eb38'; --vscode-icon=
-regex-font-family: 'codicon'; --vscode-icon-remote-explorer-content: '\eb3=
9'; --vscode-icon-remote-explorer-font-family: 'codicon'; --vscode-icon-rem=
ote-content: '\eb3a'; --vscode-icon-remote-font-family: 'codicon'; --vscode=
-icon-remove-content: '\eb3b'; --vscode-icon-remove-font-family: 'codicon';=
 --vscode-icon-replace-all-content: '\eb3c'; --vscode-icon-replace-all-font=
-family: 'codicon'; --vscode-icon-replace-content: '\eb3d'; --vscode-icon-r=
eplace-font-family: 'codicon'; --vscode-icon-repo-clone-content: '\eb3e'; -=
-vscode-icon-repo-clone-font-family: 'codicon'; --vscode-icon-repo-force-pu=
sh-content: '\eb3f'; --vscode-icon-repo-force-push-font-family: 'codicon'; =
--vscode-icon-repo-pull-content: '\eb40'; --vscode-icon-repo-pull-font-fami=
ly: 'codicon'; --vscode-icon-repo-push-content: '\eb41'; --vscode-icon-repo=
-push-font-family: 'codicon'; --vscode-icon-report-content: '\eb42'; --vsco=
de-icon-report-font-family: 'codicon'; --vscode-icon-request-changes-conten=
t: '\eb43'; --vscode-icon-request-changes-font-family: 'codicon'; --vscode-=
icon-rocket-content: '\eb44'; --vscode-icon-rocket-font-family: 'codicon'; =
--vscode-icon-root-folder-opened-content: '\eb45'; --vscode-icon-root-folde=
r-opened-font-family: 'codicon'; --vscode-icon-root-folder-content: '\eb46'=
; --vscode-icon-root-folder-font-family: 'codicon'; --vscode-icon-rss-conte=
nt: '\eb47'; --vscode-icon-rss-font-family: 'codicon'; --vscode-icon-ruby-c=
ontent: '\eb48'; --vscode-icon-ruby-font-family: 'codicon'; --vscode-icon-s=
ave-all-content: '\eb49'; --vscode-icon-save-all-font-family: 'codicon'; --=
vscode-icon-save-as-content: '\eb4a'; --vscode-icon-save-as-font-family: 'c=
odicon'; --vscode-icon-save-content: '\eb4b'; --vscode-icon-save-font-famil=
y: 'codicon'; --vscode-icon-screen-full-content: '\eb4c'; --vscode-icon-scr=
een-full-font-family: 'codicon'; --vscode-icon-screen-normal-content: '\eb4=
d'; --vscode-icon-screen-normal-font-family: 'codicon'; --vscode-icon-searc=
h-stop-content: '\eb4e'; --vscode-icon-search-stop-font-family: 'codicon'; =
--vscode-icon-server-content: '\eb50'; --vscode-icon-server-font-family: 'c=
odicon'; --vscode-icon-settings-gear-content: '\eb51'; --vscode-icon-settin=
gs-gear-font-family: 'codicon'; --vscode-icon-settings-content: '\eb52'; --=
vscode-icon-settings-font-family: 'codicon'; --vscode-icon-shield-content: =
'\eb53'; --vscode-icon-shield-font-family: 'codicon'; --vscode-icon-smiley-=
content: '\eb54'; --vscode-icon-smiley-font-family: 'codicon'; --vscode-ico=
n-sort-precedence-content: '\eb55'; --vscode-icon-sort-precedence-font-fami=
ly: 'codicon'; --vscode-icon-split-horizontal-content: '\eb56'; --vscode-ic=
on-split-horizontal-font-family: 'codicon'; --vscode-icon-split-vertical-co=
ntent: '\eb57'; --vscode-icon-split-vertical-font-family: 'codicon'; --vsco=
de-icon-squirrel-content: '\eb58'; --vscode-icon-squirrel-font-family: 'cod=
icon'; --vscode-icon-star-full-content: '\eb59'; --vscode-icon-star-full-fo=
nt-family: 'codicon'; --vscode-icon-star-half-content: '\eb5a'; --vscode-ic=
on-star-half-font-family: 'codicon'; --vscode-icon-symbol-class-content: '\=
eb5b'; --vscode-icon-symbol-class-font-family: 'codicon'; --vscode-icon-sym=
bol-color-content: '\eb5c'; --vscode-icon-symbol-color-font-family: 'c