e-icon-li=
st-selection-content: '\eb85'; --vscode-icon-list-selection-font-family: 'c=
odicon'; --vscode-icon-selection-content: '\eb85'; --vscode-icon-selection-=
font-family: 'codicon'; --vscode-icon-list-tree-content: '\eb86'; --vscode-=
icon-list-tree-font-family: 'codicon'; --vscode-icon-debug-breakpoint-funct=
ion-unverified-content: '\eb87'; --vscode-icon-debug-breakpoint-function-un=
verified-font-family: 'codicon'; --vscode-icon-debug-breakpoint-function-co=
ntent: '\eb88'; --vscode-icon-debug-breakpoint-function-font-family: 'codic=
on'; --vscode-icon-debug-breakpoint-function-disabled-content: '\eb88'; --v=
scode-icon-debug-breakpoint-function-disabled-font-family: 'codicon'; --vsc=
ode-icon-debug-stackframe-active-content: '\eb89'; --vscode-icon-debug-stac=
kframe-active-font-family: 'codicon'; --vscode-icon-circle-small-filled-con=
tent: '\eb8a'; --vscode-icon-circle-small-filled-font-family: 'codicon'; --=
vscode-icon-debug-stackframe-dot-content: '\eb8a'; --vscode-icon-debug-stac=
kframe-dot-font-family: 'codicon'; --vscode-icon-terminal-decoration-mark-c=
ontent: '\eb8a'; --vscode-icon-terminal-decoration-mark-font-family: 'codic=
on'; --vscode-icon-debug-stackframe-content: '\eb8b'; --vscode-icon-debug-s=
tackframe-font-family: 'codicon'; --vscode-icon-debug-stackframe-focused-co=
ntent: '\eb8b'; --vscode-icon-debug-stackframe-focused-font-family: 'codico=
n'; --vscode-icon-debug-breakpoint-unsupported-content: '\eb8c'; --vscode-i=
con-debug-breakpoint-unsupported-font-family: 'codicon'; --vscode-icon-symb=
ol-string-content: '\eb8d'; --vscode-icon-symbol-string-font-family: 'codic=
on'; --vscode-icon-debug-reverse-continue-content: '\eb8e'; --vscode-icon-d=
ebug-reverse-continue-font-family: 'codicon'; --vscode-icon-debug-step-back=
-content: '\eb8f'; --vscode-icon-debug-step-back-font-family: 'codicon'; --=
vscode-icon-debug-restart-frame-content: '\eb90'; --vscode-icon-debug-resta=
rt-frame-font-family: 'codicon'; --vscode-icon-debug-alt-content: '\eb91'; =
--vscode-icon-debug-alt-font-family: 'codicon'; --vscode-icon-call-incoming=
-content: '\eb92'; --vscode-icon-call-incoming-font-family: 'codicon'; --vs=
code-icon-call-outgoing-content: '\eb93'; --vscode-icon-call-outgoing-font-=
family: 'codicon'; --vscode-icon-menu-content: '\eb94'; --vscode-icon-menu-=
font-family: 'codicon'; --vscode-icon-expand-all-content: '\eb95'; --vscode=
-icon-expand-all-font-family: 'codicon'; --vscode-icon-feedback-content: '\=
eb96'; --vscode-icon-feedback-font-family: 'codicon'; --vscode-icon-git-pul=
l-request-reviewer-content: '\eb96'; --vscode-icon-git-pull-request-reviewe=
r-font-family: 'codicon'; --vscode-icon-group-by-ref-type-content: '\eb97';=
 --vscode-icon-group-by-ref-type-font-family: 'codicon'; --vscode-icon-ungr=
oup-by-ref-type-content: '\eb98'; --vscode-icon-ungroup-by-ref-type-font-fa=
mily: 'codicon'; --vscode-icon-account-content: '\eb99'; --vscode-icon-acco=
unt-font-family: 'codicon'; --vscode-icon-git-pull-request-assignee-content=
: '\eb99'; --vscode-icon-git-pull-request-assignee-font-family: 'codicon'; =
--vscode-icon-bell-dot-content: '\eb9a'; --vscode-icon-bell-dot-font-family=
: 'codicon'; --vscode-icon-debug-console-content: '\eb9b'; --vscode-icon-de=
bug-console-font-family: 'codicon'; --vscode-icon-library-content: '\eb9c';=
 --vscode-icon-library-font-family: 'codicon'; --vscode-icon-output-content=
: '\eb9d'; --vscode-icon-output-font-family: 'codicon'; --vscode-icon-run-a=
ll-content: '\eb9e'; --vscode-icon-run-all-font-family: 'codicon'; --vscode=
-icon-sync-ignored-content: '\eb9f'; --vscode-icon-sync-ignored-font-family=
: 'codicon'; --vscode-icon-pinned-content: '\eba0'; --vscode-icon-pinned-fo=
nt-family: 'codicon'; --vscode-icon-github-inverted-content: '\eba1'; --vsc=
ode-icon-github-inverted-font-family: 'codicon'; --vscode-icon-server-proce=
ss-content: '\eba2'; --vscode-icon-server-process-font-family: 'codicon'; -=
-vscode-icon-server-environment-content: '\eba3'; --vscode-ico